every day acronyms

24/7 - 24 Hours a Day, 7 Days a Week
AA - Alcoholics Anonymous
ABC - Already Been Chewed
AC - Air Conditioning
AD - Anno Domini ("In the Year of Our Lord")
AKA - Also Known As
AM - Ante Meridiem
ASAP - As Soon As Possible
ATM - Automated Teller Machine
B&B - Bed and Breakfast
BC - Before Christ or Because
BCE - Before the Common Era
BLT - Bacon, Lettuce, Tomato
BM - Bowel Movement
BYOB - Bring Your Own Beer
CC - Credit Card
CST - Central Standard Time
CSV - Comma Separated Value
CYA - Cover Your Ass
D&D - Dungeons and Dragons (a game created by TSR)
EOD - End Of Day
EST - Eastern Standard Time
ET - Extra Terrestrial
ETR - Early to Rise
FDR - Franklin Delano Roosevelt
FEAR - False Evidence that Appears Real
FYI - For Your Information
GC - General Contractor or Gift Certificate
GM - General Manager
GMO - Genetically Modified (usually as in "Non-GMO")
HAZ-MAT - Hazardous Material
ID - Identification
IQ - Intelligence Quotient
ISBN - International Standard Book Number
JFK - John Fitzgerald Kennedy
MC - Master of Ceremonies
MLK - Martin Luther King, Jr.
MO - Modus Operandi
MS - Manuscript
MST - Mountain Standard Time
MTG - Magic: The Gathering
MTD - Month To Date
NIB - New In the Box
NIH - Not Invented Here
NIMBY - Not In My Backyard
OJ - Orange Juice
PBJ - Peanut Butter and Jelly
PC - Politically Correct
PDA - Public Display of Affection
PHAT - Pretty Hot And Tempting
PI - Private Investigator
PIN - Personal Identification Number
PM - Post Meridiem
PMB - Personal Mail Box
PMS - Premenstrual Syndrome
POA - Power Of Attorney
POSH - Port Out, Starboard Home
PPS - Post Post Script
PR - Public Relations
PS - Post Script
PSI - Pounds Per Square Inch
PST - Pacific Standard Time
PTO - Paid Time Off
Q&A - Question and Answer
R&R - Rest and Relaxation
RBG - Red, Blue, Green
RIP - Rest in Peace
ROYGBIV - Red, Orange, Yellow, Green, Blue, Indigo, Violet
RPG - Role Playing Game
RSVP - R?pondez S'il Vous Pla?t (French for "Please reply")
SOB - Son of a B*tch
SOL - Sh*t Out of Luck
SOP - Standard Operating Procedure
SOS - Save Our Souls
SPF - Sun Protection Factor (how sunscreen lotion is rated)
STET - Let it Stand (an editor's mark)
TBA - To Be Announced
TBD - To Be Determined
TEAM - Together Everyone Achieves More
TEOTWAWKI - The End Of The World As We Know It
TGIF - Thank God It's Friday
TIA - Thanks In Advance
TIP - To Insure Promptness
TLC - Tender Loving Care
UFO - Unidentified Flying Object
UPC - Universal Product Code
VIP - Very Important Person
WASP - White Anglo Saxon Protestant
WOM - Word of Mouth
WTB - Want To Buy
YTD - Year To Date 

Business Acronyms

3M - Minnesota Mining and Manufacturing
3PL - Third Party Logistics
A&W - Allen & Wright (Roy Allen and Frank Wright combined their initials to name A&W Root Beer in 1922)
AA - Author Alteration (a publishing term)
AAA - American Automobile Association
ADP - Automatic Data Processing
AIG - American International Group
AMD - Advanced Micro Devices, Inc. (producer of computer chips)
AMF - American Machine & Foundry (bowling lane operators and former owners of Harley Davidson motorcycles)
AOL - America Online
AT&T - American Telephone and Telegraph
AX - Armani Exchange
B&N - Barnes & Noble
B2B - Business to Business
B2C - Business to Consumer
BBB - Better Business Bureau
BHAG - Big, Hairy Audacious Goal
BOI - Business Object Interface
CEO - Chief Executive Officer
CFO - Chief Financial Officer
CK - Calvin Klein
COB - Close Of Business
COGS - Cost of Goods Sold
COLA - Cost of Living Adjustment
COO - Chief Operating Officer
CPK - California Pizza Kitchen
CRM - Client Relationship Management
CSP - Certified Speaking Professional
CTO - Chief Technology Officer
DBA - Doing Business As
DHL - Dalsey, Hillblom and Lynn (founders of DHL Worldwide Express)
DK - Dorling Kindersley
DKNY - Donna Karan New York
DSO - Days Sales Outstanding
DSW - Discount Shoe Warehouse
EA - Electronic Arts
EBX - Electronics Boutique X
EMS - Eastern Mountain Sports
FANNIE MAE - Federal National Mortgage Association (a privately owned corporation)
FLP - Family Limited Partnership
FSB - Fortune Small Business
FT - Full Time
FTE - Full Time Equivalent
FUBU - For Us, By Us
GE - General Electric
GEICO - Government Employees Insurance Company
GM - General Motors or General Mills
GNC - General Nutrition Centers
HP - Hewlett Packard
IBC - Independent Breweries Company (original manufacturer of IBC Root Beer)
IBD - Investors Business Daily
IBM - International Business Machines Corporation
ILM - Industrial Light and Magic
IMR - Information Management Research
ING - Internationale Nederlanden Group (a financial company)
IREA - Intermountain Rural Electric Association
JC Penney's - James Cash Penney
JOA - Joint Operating Agreement (example: the relationship between The Denver Post and The Rocky Mountain News)
JVC - Japan's Victor Company
KB - Kaybee Toys OR Kaufmann Broad (home builder)
KFC - Kentucy Fried Chicken
KPI - Key Performance Indicator
KPMG - Klynveld Peat Marwick Goerdeler (accounting firm)
LLC - Limited Liability Company
LLP - Limited Liability Partnership
MCI - Microwave Communications Incorporated
MOH - Message/Music On Hold
MSI - Multiple Streams of Income
MSN - Microsoft Network
MSRP - Manufacturer's Suggested Retail Price
MVI - Mini Vacations Incorporated
NBB - New Belgium Brewery
NCOA - National Change of Address (List)
NDA - Non-Disclosure Agreement
NIB - New In the Box
NSA - National Safety Associates
OPM - Other People's Money
OPR - Other People's Resources
OPT - Other People's Time
P&G - Proctor and Gamble
PBGC - The Pension Benefit Guaranty Corporation
PE - Printer Error (a publishing term)
PL - Profit and Loss
PO - Purchase Order
POP - Point of Purchase
PT - Part Time
QA - Quality Assurance
QAI - Quality Assurance International
QC - Quality Control
QSC - Quality, Service, Cleanliness (Ray Kroc's motto for McDonald's)
REI - Recreational Equipment, Inc
RFP - Request for Proposal
SBC - Southwestern Bell Corporation
SBI - Site Build It! (software for building web sites)
SFI - Six-Figure Income
SKU - Stock Keeping Unit
SM - Service Mark
SOHO - Small Office, Home Office
SOS - Switched On Schoolhouse
SYSTEM - Save YourSelf Time, Engergy, and Money (as reported by www.just15minutes.com)
TCBY - The Country's Best Yogurt (originally This Can't Be Yogurt)
TM - Trademark
TSR - Tactical Studies Rules (company that produces Dungeons & Dragons)
UMB - United Missouri Bank
UPS - United Parcel Service
USAA - United Services Automobile Association 

Car & Automotive Acronyms

4WD - Four-Wheel Drive
AAA - American Automobile Association
ABS - Anti-Lock Braking System
AC - Air Conditioning
AMG - Aufrecht, Melcher, Grossaspach (see www.mbusa.com)
ATV - All Terrain Vehicle
AWD - All-Wheel Drive
BMW - Bayerische Motoren Werke (Bavarian Motor Works)
CAA - Canadian Auto Association
CAFE - Corporate Average Fuel Economy
DOHC - Dual Overhead Camshafts
EFI - Electronic Fuel Injection
FIAT - Fabbrica Italiana Automobili Torino
GM - General Motors
GMC - General Motors Corporation
GT - Gran Turismo or Grand Tourism
GTO - Grand Tourism Over (refers to engine displacement compared to the competition maximum for the GT category)
GTU - Grand Tourism Under (refers to engine displacement compared to the competition maximum for the GT category)
HEMI - Hemispherical Combustion Chamber
IFS - Infiniti Financial Services
IHI - Ishikawajima Harima Heavy Industries (turbo manufacturers)
KKK - Kuhnle, Kopp & Kausch (turbo manufacturers)
LTD - Limited
MPG - Miles Per Gallon
MR2 - Mid-engine Runabout/Rear-drive two-seater (Toyota)
NMAC - Nissan Motor Acceptance Corporation
OEM - Original Equipment Manufacturer (usually in reference to car parts)
OHV - Overhead valve
PSA - Peugeot-Citro?n SA
RV - Recreational Vehicle
SOHC - Single Overhead Camshaft
TDI - Turbodiesel Intercooler
TRD - Toyota Racing Development
TT - Touring Turismo
USAA - United Services Automobile Association
VW - Volkswagen
YMMV - Your Mileage May Vary 

Chat Acronyms

A3 - Anytime, Anyplace, Anywhere
A/S/L - Age, Sex, Location
B4N - (Good)Bye For Now
BCNU - Be Seeing You
BIL - Brother In-Law
BM Val - Be My Valentine
BOL - Best of Luck
BRB - Be Right Back
BTW - By the Way...
CU@ - See You At...
CUNT - Can't Understand Normal Thinking
CUL - See You Later
DD - Dear Daughter
DH - Dear Husband
DNR - Dinner
DS - Dear Son
DW - Dear Wife
EZ - Easy
F8 - Fate (as in "It's fate.")
FIL - Father In-Law
FWIW - For What It's Worth
FYI - For Your Information
GMTA - Great Minds Think Alike
HAND - Have a Nice Day
HRU - How Are You?
IAD8 - It's a Date
IM - Instant Message
IM4U - I'm for You
IMME - Instant Message Me (i.e., "Send me an instant message.")
IMHO - In My Humble Opinion
IMNSHO - In My Not So Humble Opinion
IRL - In Real Life
IYKWIM - If You Know What I Mean?
JK - Just Kidding
JMHO - Just My Humble Opinion
KOTC - Kiss on the Cheek
KWIM - Know What I Mean?
L8R - Later
LDR - Long Distance Relationship
LOL - Laughing Out Loud
LSKOL - Long, Slow Kiss on the Lips
LTNS - Long Time, No See
MHO - My Humble Opinion
MIL - Mother In-Law
MTE - My Thoughts Exactly
MU - Miss You
MUSM - Miss You So Much
NE1 - Anyone
NP - No Problem
OIC - Oh, I See!
OTOH - On The Other Hand
PCM - Please Call Me
PLS - Please
QT - Cutie
ROFL - Rolling on Floor, Laughing
ROFLOL - Rolling on Floor, Laughing Out Loud
RTFM - Read the "Bleeping" Manual
RUOK - Are You OK?
SAHM - Stay-At-Home Mom
SIL - Sister In-Law
TGIF - Thank God It's Friday
THNQ - Thank You
TIA - Thanks In Advance
TIE - Take It Easy
TMI - Too Much Information
TTFN - Ta-Ta for Now
TTYL - Talk To You Later
TTYS - Talk To You Soon
U4E - Yours Forever
UR4ME - You Are for Me
UROK - You Are OK
XLNT - Excellent
XO - Hugs and Kisses
YGM - You Got Mail
YMMV - Your Mileage May Vary 

Education Acronyms

ABE - Adult Basic Education
ACT - American College Test
AP - Advanced Placement
BMOC - Big Man On Campus
CE - Continuing Education
CSAP - Colorado Student Assessment Program
EOC - End-of-Course
EOG - End-of-Grade
FCAT - Florida's Comprehensive Assessment Test
GED - General Education Diploma
GMAT - Graduate Management Admission Test
GPA - Grade Point Average
GRE - Graduate Record Examination
HS - High School
IEP - Individualized Educational Plan
IHS - I Hate School
JV - Junior Varsity
LA - Language Arts
LSAT - Law School Admission Test
MEAP - Massachusetts Educational Assessment Program
NCLB - No Child Left Behind
NEA - National Education Association
OT - Occupational Therapy
PTA - Parent-Teacher Association
SAT - Scholastic Assessment Test
TA - Teacher's Aide
VBS - Vacation Bible School 

Financial Acronyms

ADR - American Depository Receipt
AIG - American International Group
AIR - Assumed Interest Rate
AMEX - American Express (credit card)
APR - Annual Percentage Rate
ARM - Adjustable Rate Mortgage
ATM - Automated Teller Machine
CB - Carte Blanche (as in Diner's Club Carte Blanche credit card)
CBD - Commerce Business Daily
CD - Certificate of Deposit
CDSC - Contingent Deferred Sales Charge
CFP - Certified Financial Planner
CMO - Collateralized Mortgage Obligation
CUSIP - Committee on Uniform Securities Identification Procedures
DB - Defined Benefit (retirement plan; for example, a pension)
DC - Defined Contribution (retirement plan; for example, a 401(k) plan)
DCA - Dollar Cost Averaging
DR - The Daily Reckoning
DTCC - Depository Trust & Clearing Corporation
EFT - Electronic Funds Transfer
EPS - Earnings Per Share
ERISA - Employee Retirement Income Security Act of 1974
ETF - Exchange Traded Funds
FASB - Financial Accounting Standards Board
FDIC - Federal Deposit Insurance Corporation
FIFO - First In, First Out
FOMC - Federal Open Market Committee
FOREX - Foreign Exchange
FRB - Federal Reserve Board
GDP - Gross Domestic Product
GL - General Ledger
GNP - Gross National Product
GO - General Obligation Bond
GUDD - Gold Up, Dollar Down
IA - Investment Adviser
IBD - Investors Business Daily
IFS - Infiniti Financial Services
IMF - International Monetary Fund
ING - Internationale Nederlanden Group (a financial company)
IOU - I Owe You
IPO - Initial Public Offering
IRA - Individual Retirement Account
IVA - Individual Voluntary Arrangements
JTWROS - Joint Tenants With Rights of Survivorship
LOI - Letter Of Intent
MMKT - Money Market
MPT - Modern Portfolio Theory
MSI - Multiple Streams of Income
NASD - National Association of Securities Dealers
NASDAQ - National Association of Securities Dealers Automated Quotation (system)
NAV - Net Asset Value
NL - No Load
NMAC - Nissan Motor Acceptance Corporation
NYSE - New York Stock Exchange
OPM - Other People's Money
OSJ - Office of Supervisory Jurisdiction
OTC - Over the Counter
PBGC - The Pension Benefit Guaranty Corporation
PE - Price to Earnings (Ratio)
PMI - Private Mortgage Insurance
POP - Public Offering Price
PPT - Plunge Protection Team (an unknown buyer who "makes the market" during sharp downturns)
PSP - Profit Sharing Plan
REIT - Real Estate Investment Trust
ROE - Return on Equity
ROI - Return on Investment
RR - Registered Representative
S&P - Standard & Poor's
SAI - Statement of Additional Information
SEC - Securities Exchange Commission
SEP - Simplified Employee Pension
SEQUINS - Select Equity Indexed Notes
SIPC - Securities Investor Protection Corporation
SRO - Self-Regulatory Organization
STC - Securities Training Corporation
TSA - Tax-Sheltered Annuity
UGMA - Uniform Gifts To Minors Act
UTMA - Uniform Transfers To Minors Act
WAC - With Approved Credit
WSJ - Wall Street Journal
YTM - Yield To Maturity 

Geography Acronyms

ANWR - Arctic National Wildlife Refuge
BC - British Columbia
DC - District of Columbia
DIA - Denver International Airport
DFW - Dallas/Fort Worth
GPS - Global Positioning System
LA - Los Angeles
LAX - Los Angeles International Airport
LODO - Lower Downtown (an historic section of Denver)
NCOA - National Change Of Address
NMSZ - New Madrid Seismic Zone (in Missouri)
NOLA - New Orleans, Louisiana
NYC - New York City
TOPO - Topographical Map
USGS - United States Geological Survey
USSR - Union of Soviet Socialist Republics
ZIP - Zone Improvement Plan 

Government Acronyms

ADA - Americans with Disabilities Act
AMT - Alternative Minimum Tax
CAN-SPAM - Controlling the Assault of Non-Solicited Pornography and Marketing Act of 2003
CFR - Council on Foreign Relations
CIA - Central Intelligence Agency
COG - Continuity of Government
DARPA - Defense Advanced Researchs Progect Agency (www.darpa.mil)
DEA - Drug Enforcement Agency
DOD - Department of Defense
DOE - Department Of Energy
DOL - Department of Labor
DOT - Department of Transportation
DUI - Driving Under the Influence
DWI - Driving While Intoxicated
EPA - Environmental Protection Agency
EPRI - Electric Power Research Institute
ESA - European Space Agency
EU - European Union
FAR - Federal Acquisition Regulation
FBI - Federal Bureau of Investigation
FCC - Federal Communications Commission
FDA - Food and Drug Administration
FDIC - Federal Deposit Insurance Corporation
FEMA - Federal Emergency Management Agency
FERPA - Family Educational Records Privacy Act
FLSA - Fair Labor Standards Act
FREDDIE MAC - Federal Home Loan Mortgage Corporation
FTC - Federal Trade Commission
GDP - Gross Domestic Product
GINNIE MAE - Government National Mortgage Association
GNP - Gross National Product
GOP - Grand Old Party
HONDA - Home School Non-Discrimination Act
HUD - U.S. Department of Housing and Urban Development
JCS - Joint Chiefs of Staff
OSHA - Occupational Safety and Health Administration OR Occupational Safety and Health Act of 1970
PC - Politically Correct
NAFTA - North American Free Trade Agreement
NASA - National Aeronautics and Space Administration
NCIS - National Criminal Intelligence Service (U.K.)
NDIU - National Drugs Intelligence Unit (U.K.)
NSA - National Security Agency
NSC - National Security Council
RICO - Racketeer Influenced and Corrupt Organization Act
SBA - Small Business Administration
SLORC - State Law and Order Restoration Council
SOCA - Serious Organised Crime Agency (U.K.)
SSA - Social Security Administration
SSN - Social Security Number
SWAT - Special Weapons and Tactics
TIN - Tax Identification Number
UDHR - Universal Declaration on Human Rights
UN - United Nations
UNEP - United Nations Environment Program
UNFPA - United Nations Fund for Population Activities (see www.unfpa.org)
USA PATRIOT - Uniting and Strengthening America by Providing Appropriate Tools Required to Intercept and Obstruct Terrorism (a government act passed in late 2001)
USAF - United States Air Force
USDA - United States Department of Agriculture
USGS - United States Geological Survey
USPS - United States Postal Service
UGMA - Uniform Gifts To Minors Act
UTMA - Uniform Transfers To Minors Act 

Internet Acronyms

ADT - Average Daily Traffic
AOL - America Online
ASP - Active Server Page (web scripting language)
BB - Bulletin Board
BCC - Blind Carbon Copy
BCF - Bike Chat Forums (an online forum for discussion about motorcycles)
BLOG - short for "Web Log"
bps - Bits Per Second
Bps - Bytes Per Second
BSD - Berkeley Software Distribution
CC - Carbon Copy
CGI - Common Gateway Interface (web scripting facility)
CPC - Cost Per Click
CSS - Cascading Style Sheet
DMOZ - Directory Mozilla
DNSBL - Domain Name Service Black List
DSL - Digital Subscriber Line
FFA - Free For All
FTP - File Transfer Protocol
Gbps - Gigabit Per Second
GBps - Gigabyte Per Second
HTML - Hyper Text Mark-up Language
HTTP - Hyper Text Transfer Protocol
ICANN - Internet Corporation For Assigned Names and Numbers
IP - Internet Protocol
ISP - Internet Service Provider
Kbps - Kilobit Per Second
KBps - Kilobyte Per Second
Mbps - Megabit Per Second
MBps - Megabyte Per Second
Modem - MODulator-DEModulator
MSN - Microsoft Network
ODP - Open Directory Project
P2P - Peer to Peer (as in music file sharing systems like KaZaA)
PHP - Personal Home Page (original name for PHP scripting language)
PLR - Private Label Rights
PMB - Private Message Board
POP3 - Post Office Protocol, Version 3
PPC - Pay Per Click (a search engine advertising model)
RSS - Really Simple Syndication (for RSS 0.9x)OR RDF Site Summary (for RSS 1.0)
SEO - Search Engine Optimization
SMTP - Simple Mail Transfer Protocol
SSL - Secure Sockets Layer
TLD - Top-Level Domain
UCE - Unsolicited Commercial Email
URL - Uniform Resource Locator (web address)
VRE - Virtual Real Estate
W3 - WWW (World Wide Web)
Wi-Fi - Wireless Fidelity
WWW - World Wide Web
WYSIWYG - What You See Is What You Get
XFN - XHTML Friends Network (see http://gmpg.org/xfn/)
XML - eXtensible Markup Language

Media Acronyms

A&E - Arts and Entertainment
ABC - American Broadcasting Corporation
AFV - America's Funniest Videos
AMC - American Multi-Cinema
AP - Associated Press
BBC - British Broadcasting Corporation
BMG - Bertelsmann Music Group
CBS - Columbia Broadcasting System or Central Broadcasting Station
CCM - Contemporary Christian Music (a Christian magazine)
CNN - Cable News Network
CR - Consumer Reports
CSI - Crime Scene Investigation
ESPN - Entertainment and Sports Programming Network
FHM - For Him
FNC - Fox News Channel
FSB - Fortune Small Business
GQ - Gentleman's Quarterly
HBO - Home Box Office
IBD - Investors Business Daily
LBN - Levine Breaking News (see www.lcoonline.com)
MCA - The Music Corporation of America
MGM - Metro-Goldwyn Mayer
MTV - Music Television
NBC - National Broadcasting Corporation
NPR - National Public Radio
PBS - Public Broadcasting System
RCA - Radio Corporation of America
SKG - Spielberg, Katzenberg,and Geffen (DreamWorks)
SNL - Saturday Night Live
SWK - Star Wars Kid (see www.jedimaster.net)
TBN - Trinity Broadcasting Network
TLC - The Learning Channel
TNN - The National Network
VH1 - Video Hits #1
VMA - Video Music Awards (put on by MTV)
WSJ - Wall Street Journal 

Medical & Science Acronyms

ACL - Anterior Cruciate Ligament (ligament often torn in knee injuries)
ADD - Attention Deficit Disorder
ADHD - Attention Deficit Hyperactivity Disorder
AIDS - Acquired Immune Deficiency Syndrome
ALA - Alpha-Linoleic Acid
AMD - Age-related Macular Degeneration
BBS - Bashful Bladder Syndrome
BGH - Bovine Growth Hormone
BHT - Butylated Hydroxytoluene (a preservative found in nearly every breakfast cereal)
BMI - Body Mass Index
BMR - Basil Metabolic Rate
CAM - Complimentary and Alternative Medicine
CBT - Cognitive Behavioral Therapy
CHD - Coronary Heart Disease
CPR - Cardiopulmonary Resuscitation
DHA - Docosahexanoic Acid
DNA - Deoxyribonucleic Acid
DOA - Dead On Arrival
EFA - Essential Fatty Acids
ELS - Equidistant Letter Sequences (as employed in The Bible Code)
EMT - Emergency Medical Technician
EPA - Eicosapentaenoic Acid
ER - Emergency Room
FAS - Fetal Alcohol Syndrome
fMRI - Functional Magnetic Resonance Imaging
GD - Gestational Diabetes
GLA - Gamma-Linoleic Acid
HDL - High-Density Lipoprotein (a type of cholesterol)
HEPA - High-Efficiency Particulate Air (Filter)
HIPAA - Health Insurance Portability and Accountability Act
HIV - Human Immunodeficiency Virus
HMO - Health Maintenance Organization
HPV - Human Papilloma Virus
HRT - Hormone Replacement Therapy (man-made drugs used to ease the symptoms of menopause)
HSA - Health Savings Account
ICU - Intensive Care Unit
IRC - Infrared Coagulation (hemorrhoid treatment)
IV - Intravenous
LDL - Low-Density Lipoprotein (a type of cholesterol)
LSD - Lysergic Acid Diethylamide
AO - Monoamine Oxidase (Inhibitors)
MAOI - Monoamine Oxidase Inhibitors
MR/DD - Mentally Retarded/Developmentally Disabled
MRI - Magnetic Resonance Imaging
MS - Multiple Sclerosis
MSG - Monosodium Glutamate
NICU - Neonatal Intensive Care Unit
NLP - Neuro Linguistic Programming
NSAID - Non-Steroidal Anti-Inflammatory Drug
OCD - Obsessive-Complusive Disorder
OD - Overdose
PICU - Pediatric Intensive Care Unit
PMS - Premenstrual Syndrome
rBGH - Recombitant Bovine Growth Hormone
REM - Rapid Eye Movement
RN - Registered Nurse
RNA - Ribonucleic Acid or Registered Nurse Anesthetist
SEPAC - Space Experiments with Particle Accelerators
SIDS - Sudden Infant Death Syndrome
STD - Sexually Transmitted Disease
TB - Tuberculosis
TMJ - Temporomandibular Joint syndrome
TNT - Trinitrotoluene
TS - Tuberous Sclerosis
VAERS - Vaccine Adverse Events Reporting System
VD - Venereal Disease
VLDL - Very-Low-Density Lipoprotein (a type of cholesterol)
VOC - Volatile Organic Compound 

Military Acronyms

AFESC - Air Force Electronic Security Command
ASVAB - Armed Services Vocational Aptitude Battery
AWOL - Away Without Leave
ASW - Anti-Submarine Warfare
BDU - Battle Dress Uniform
BOHICA - Bend Over, Here It Comes Again...
CO - Commanding Officer
DIA - Defence Intelligence Agency
DIS - Defence Investigative Service
DISCO - Defence Industry Security Command
DLAB - Defense Language Aptitude Battery
DLI - Defense Language Institute
FUBAR - "Fudged" Up Beyond All Recognition (polite form)
GI - Government Issue (as in GI Joe)
ICBM - Intercontinental Ballistic Missile
INSCOM - U.S. Army Intelligence and Security Command
JAG - Judge Advocate General
KIA - Killed In Action
MEPS - Military Entrance Processing Station
MIA - Missing In Action
MOS - Military Operations Specialty
MRE - Meal Ready to Eat
NCIS - Naval Criminal Investigation Service
NCO - Non-Commissioned Officer
NIS - Naval Investigative Service
NORAD - North American Aerospace Defense Command
NRO - National Reconnaissance Office
ONI - U.S. Navy Office of Naval Intelligence
POW - Prisoner of War
PSYOPS - Psychological and Psychotronic Warfare
PT - Physical Training
ROTC - Reserve Officers Training Corps
SAP - Semi-Armor-Piercing
SNAFU - Situation Normal All "Fudged" Up (polite form)
TCN - Third Country Nationals
TLF - Temporary Lodging Facility
USAF - United States Air Force
USMC - United States Marine Corps
WMD - Weapons of Mass Destruction
WWI - World War One
WWII - World War Two 

Music & Musician Acronyms

AOR - Album Oriented Rock
ATYCLB - All That You Can't Leave Behind (by U2)
AWB - Average White Band
BOC - Blue Oyster Cult
CCR - Creedence Clearwater Revival
CJA - Christian Jazz Artists
CMF - Creative Music Format
CSN - Crosby, Stills & Nash
DC Talk - Decent Christian Talk (alternative: District of Columbia, the location the band members met)
DJ - Disc Jockey
ELP - Emerson, Lake & Palmer
EP - Extended Play (Record)
FFH - Far From Home
GNP - Gabber Nullification Project
HTDAAB - How To Dismantle an Atomic Bomb (by U2)
ICP - Insane Clown Posse
LAMC - Latin Alternative Music Conference
LP - Long Play (Record)
MXPX - Magnified Plaid
NBA - National Band Association
NIN - Nine-Inch Nails
OC Supertones - Orange County Supertones
POD - Payable On Death
REM - Rapid Eye Movement
STP - Stone Temple Pilots
TFK - Thousand Foot Krutch 

Organization Acronyms

4H - Head, Heart, Hands, Health
AA - Alcoholics Anonymous
AARP - American Association of Retired Persons
ABC - Always Buy Colorado
ACL - American Consultants League
ACLU - American Civil Liberties Union
ADA - American Dental Association
ADF - Alliance Defense Fund
AFC - Ambassadors for Christ
APS - Apostrophe Protection Society
APWG - Anti-Phishing Working Group
AWAI - American Writers and Artists Institute
BBB - Better Business Bureau
CAA - Canadian Auto Association
CAP - Civil Air Patrol
CARA - The Classification and Rating Administration (see www.filmratings.com)
CJA - Canadian Jewelers Association
COMPA - Conference of Minority Public Administrators
DAN - Divers Alert Network
DAR - Daughters of the American Revolution
DMA - Direct Marketing Association
DMEF - Direct Marketing Educational Foundation
FCA - Fellowship of Christian Athletes
FRC - Family Research Council
GUE - Global Underwater Explorers
HSLDA - Home School Legal Defense Association
IAHBE - International Association of Home Business Entrepreneurs
IANTD - International Association of Nitrox and Technical Divers
IOC - International Olympic Committee
IPA - International Paruresis Association
ISO - International Organization for Standardization
KKK - Klu Klux Klan
MADD - Mothers Against Drunk Driving
MOPS - Mothers of Pre-Schoolers
NABET - National Association of Broadcast Employees and Technicians
NBA - National Business Association
NEA - National Education Association
NIFL - National Institute for Literacy
NRA - National Rifle Association
NUMA - National Underwater and Marine Agency (founded by author Clive Cussler)
OECD - Organization of Economic Cooperation and Development
OPEC - Organization of the Petroleum Exporting Countries
PADI - Professional Association of Diving Instructors
PEAH - Parents Educating at Home
PK - Promise Keepers
RIAA - Recording Industry Association of America OR Rural Internet Access Authority
SWEPA - Subscription Website Publishers' Association
TNL - The Next Level
WIPO - World Intellectual Property Organisation
WQA - Water Quality Association
WWF - World Wildlife Fund
YFC - Youth for Christ
YMCA - Young Men's Christian Association
YOF - Youth Outdoors Foundation
YWAM - Youth With A Mission 

Plastic Acronyms

PETE - Polyethylene Terephthalate (#1 plastic)
HDPE - High-Density Polyethylene (#2 plastic)
PV - Polyvinyl Chloride (#3 plastic, also called PVC)
LDPE - Low-Density Polyethylene (#4 plastic)
PP - Polypropylene (#5 plastic)
PS - Polystyrene (#6 plastic)


Real Estate Acronyms

AIREA - American Institute of Real Estate Appraisers
ALTA - American Land Title Association
ANSI - American National Standards Institute
AOR - Association of Realtors
ARES - American Real Estate Society
ASA - American Society of Appraisers
ASHI - American Society of Home Inspectors
BD - Book Depreciation
BFP - Bona Fide Purchaser
BRR - Book Rate of Return
CAM - Common Area Maintenance (charges related to commercial leases)
CC - Civil Code
CGT - Capital Gains Tax
CH/BW - Chain Link/Barbed Wire
CO - Certificate of Occupancy
COE - Cost of Equity
CUV - Current Use Value
DD214 - Used to discharge service members in the 1950s
DIM - Deferred-Interest Mortgage
DRC - Depreciated Replacement Cost
DS - Due on Sale (clause)
EAL - Exclusive Agency Listing
ERV - Estimated Rental Value
FDR - Formal Dining Room
FMV - Fair Market Value
FP - Fireplace
FPM - Flexible-Payment Mortgage
FRM - Fixed-Rate Mortgage
FRV - Full Rental Value
FSBO - For Sale By Owner
GPM - Graduated Payment Mortgage
GRM - Gross Rent Multiplier
HDW - Hardwood Floors
HECM - Home Equity Conversion Mortgage
HEL - Home Equity Loan
HOA - Home Owners' Association
HUD - (Department of) Housing and Urban Development
HWF - Hardwood Floors
HVAC - Heating, Ventilation, and Air Conditioning
LIBOR - London Interbank Offered Rate
LTV - Loan To Value (Ratio)
LUI - Land Use Intensity
MBA - Mortgage Bankers Association of America
MBB - Mortgage-Backed Bond
MBO - Mortgage-Backed Obligation
MBS - Mortgage-Backed Security
MGIC - Mortgage Guaranty Insurance Corporation
MLS - Multiple Listing Service
MMI - Mutual Morgage Insurance
MPC - Master Planned Community
MRA - Master Residential Appraiser
MSA - Master Senior Appraiser
NHBC - National House Building Council
NIA - Net Internal Area
NIM - Net Income Multiplier
NLA - Net Leasable Area
NNN - Triple Net (Lease)
NOI - Net Operating Income
NPV - Net Present Value
NRV - Net Realizable Value
OBO - Or Best Offer
OER - Operating Expense Ratio
OIRO - Offers In the Region Of...
PCD - Planned Commercial Development
PEPS - Political, Economic, Physical, Social (forces that drive value)
PHA - Public Housing Administration
PID - Planned Industrial Development
PITI - Principal, Interest, Taxes, and Insurance
PMDT - Purchase Money Deed of Trust
PMI - Private Mortgage Insurance
PO - Principal Only
PSF - Per Square Foot
PV - Present Value
PW - Present Worth
RAM - Reverse Annuity Mortgage
REA - Reciprocal Easement Agreement
REIT - Real Estate Investment Trust
REC - Real Estate Commission
REO - Real Estate Owned
ROM - Roll-Over Mortgage
SAM - Shared-Appreciation Mortgage
SEM - Shared-Equity Mortgage
SFD - Single Family Detached
TPL - Third Party Liability
TI - Tenant Improvement
TIC - Tenants In Common
TIP - Treasury Investment Program
TRA - Tax Reform Act
VA - Veterans Administration (Loan)
VAP - Variable Payment (Mortgage)
VAT - Value Added Tax
VPM - Variable-Payment Mortgage
VRE - Virtual Real Estate
VRM - Variable-Rate Mortgage 

Religious Acronyms

ACTS - Adoration, Contrition, Thanksgiving, Supplication
AV - Authorized Version (an alternative way to refer to the King James Version)
CCM - Contemporary Christian Music (a Christian magazine)
CRCA - Christian Reformed Churches of Australia (see www.crca.org.au)
IHS - Iesus Hominum Salvator (Latin: Jesus, Savior of Men)
JC - Jesus Christ
KJV - King James Version (of the Bible)
LDS - Church of Jesus Christ of Latter Day Saints
MK - Missionary Kid
NASB - New American Standard Bible
NIV - New International Version (of the Bible)
NKJV - New King James Version (of the Bible)
PRAY - Praise, Repent, Ask, Yield
PUSH - Pray Until Something Happens
PK - Preacher's Kid
TNIV - Today's New Internation Version (of the Bible)
VBS - Vacation Bible School
WWJD - What Would Jesus Do? 

Sports Acronyms

AFC - American Football Conference
AVG - Average (usually in reference to batting average)
DNF - Did Not Finish (Race)
DNS - Did Not Start (Race)
DT - Dual Taper (a type of fly fishing line)
DQ - Disqualified
ESPN - Entertainment and Sports Programming Network
FIS - F?d?ration Internationale de Ski
GS - Giant Slalom
HALO - High Altitude, Low Opening (skydiving term)
HIT - High Intensity Training
IOC - International Olympic Committee
ISF - International Snowboard Federation (now defunct) OR International Softball Federation
KO - Knockout
LPGA - Ladies Professional Golf Association
MLB - Major League Baseball
NASCAR - National Association for Stock Car Auto Racing
NBA - National Basketball Association OR National Boxing Association
NCAA - National Collegiate Athletic Association
NFC - National Football Conference
NFL - National Football League
OBP - On-Base Percentage (baseball term)
PGA - Professional Golfers' Association
PB - Personal Best
PFT - Power Factor Training
PIYO - Pilates & Yoga
PPND - Postponed
PR - Personal Record
QB - Quarterback
RBI - Runs Batted In (baseball metric similar to assists in basketball)
SCT - Static Contraction Training
SCUBA - Self-Contained Underwater Breathing Apparatus
SLG - Slugging Percentage (baseball term)
TD - Touchdown
TT - Triangle Taper (a type of fly fishing line)
UFC - Ultimate Fighting Championship
W2W - Wheel To Wheel (auto racing)
WEC - World Extreme Cagefighting
WTF - World Taekwondo Federation
WFF - Weight Forward Floating (a type of fly fishing line)
WFS - Weight Forward Sinking (a type of fly fishing line)
WPT - World Poker Tour
WWF - World Wrestling Federation
XC - Cross Country 

State Abbreviations

AL - Alabama
AK - Alaska
AR - Arkansas
AZ - Arizona
CA - California
CO - Colorado
CT - Connecticut
DC - District of Columbia
DE - Delaware
FL - Florida
GA - Georgia
HA - Hawaii
IA - Iowa
ID - Idaho
IL - Illinois
IN - Indiana
KS - Kansas
KY - Kentucky
LA - Louisiana
MA - Massachussets
MD - Maryland
ME - Maine
MI - Michigan
MN - Minnesota
MO - Missouri
MS - Mississippi
MT - Montana
NC - North Carolina
ND - North Dakota
NE - Nebraska
NH - New Hampshire
NJ - New Jersey
NM - New Mexico
NV - Nevada
NY - New York
OH - Ohio
OK - Oklahoma
OR - Oregon
PA - Pennsylvania
PR - Puerto Rico
RI - Rhode Island
SC - South Carolina
SD - South Dakota
TN - Tennessee
TX - Texas
UT - Utah
VA - Virginia
VT - Vermont
WA - Washington
WI - Wisconsin
WV - West Virginia
WY - Wyoming
USA - United States of America 

Technology & Electronics Acronyms

3D - Three-dimensional
AC - Alternating Current
ADT - Abstract Data Type
AI - Artificial Intelligence
AM - Amplitude Modulation
API - Application Programming Interface
ASP - Active Server Page (web scripting language)
BIOS - Basic Input Output System
CB - Citizens' Band Amateur Radio
CD - Compact Disc
CE - Conformit?e Europ?enne (Translated literally, it means European Conformity. "The CE Marking indicates that the product complies with all European requirements and conformity assessment procedures that apply to it." Source: http://www.cemarking.net)
CG - Computer Graphics
CGI - Common Gateway Interface (web scripting facility)
CIA - Computer Industry Almanac
CPU - Central Processing Unit
CRT - Cathode Ray Tube (type of TV)
DC - Direct Current
DOS - Disk Operating System
DPI - Dots per Inch
DSL - Digital Subscriber Line
DSS - Digital Spread Spectrum
DTS - Digital Theater Sound
DVD - Digital Video
DVR - Digital Video Recorder
ECM - Electronic Countermeasure
EDI - Electronic Data Interchange
EIA - Electronic Industries Alliance
EMP - Electro Magnetic Pulse
EULA - End User License Agreement (usually in reference to software)
FM - Frequency Modulation
GIF - Graphic Interchange Format
GUI - Graphic User Interface
HDTV - High Definition Television
HEPA - High-Efficiency Particulate Air (filter)
Hi-Fi - High Fidelity
HID - High Intensity Discharge
HUP - Home Use Program (Microsoft)
IT - Information Technology
JPEG - Joint Photographic Experts Group (24-bit image storage format)
LAN - Local Area Network
LASER - Light Amplification by Stimulated Emission of Radiation
LCD - Liquid Crystal Display
LED - Light Emitting Diode
MDK - Multimedia Developers Kit
MOM - Message Oriented Middleware
MP3 - Moving Picture Experts Group Layer-3 Audio
MRAM - Magnetic Random Access Memory
NA - Numeric Aperature
NIH - Not Invented Here
OLED - Organic Light Emitting Diode
OS - Operating System
PA - Public Address (System)
PC - Personal Computer
PDA - Personal Digital Assistant (like a Palm® Pilot)
PDF - Portable Document Format (created by Adobe Acrobat)
PHP - Personal Home Page (original name for PHP scripting language)
PLR - Personal Life Recorder (a recording device that relies on MRAM for its viability)
POP3 - Post Office Protocol, Version 3
POTS - Plain Old Telephone Service
PS2 - Play Station 2
PS3 - Play Station 3
PVC - Polyvinyl Chloride
CSQA - Certified Software Quality Analyst
CSTE - Certified Software Test Engineer
RADAR - Radio Detecting and Ranging
RAM - Random Access Memory
RC - Remote Control
RDF - Rich Data Format
RFID - Radio Frequency Identification Device
ROM - Read Only Memory
SMTP - Simple Mail Transfer Protocol
SONAR - Sound Navigation & Ranging
SSL - Secure Sockets Layer
SUMMA - System for Universal Multi Media Access
SUMS - System for Universal Media Searching
TDD - Telecommunication Device for the Deaf
TTY - Teletypewriter, also referred to as a Text Telephone (how the hearing impaired use telephones)
TV - Television
UI - User Interface
UL - Underwriters Laboratories Incorporated
UPS - Uninterrupted Power Source
USB - Universal Serial Bus
VCR - Videocassette Recorder
VOD - Video On Demand
VoIP - Voice-over Internet Protocol
VHS - Video Home System 